FAO = "countries/Free Angola.txt"
OCE = "countries/Oceania.txt"
SNG = "countries/Senegambia.txt"
SAO = "countries/South African Opposition.txt"
TNI = "countries/Transkei.txt"
VDA = "countries/Venda.txt"
ISI = "countries/Islamic State of Indonesia.txt"
DLM = "countries/Dalmatia.txt"
DAR = "countries/Danubian Soviet Republics.txt"
SSU = "countries/South Sudan.txt"
BHA = "countries/Independent India.txt"
VAT = "countries/Vatican.txt"
SNM = "countries/San Marino.txt"
LIE = "countries/Liechtenstein.txt"
ADN = "countries/Andorra.txt"
MNO = "countries/Monaco.txt"
SYE = "countries/South Yemen.txt"
RSF = "countries/Russian SFSR.txt"
KAT = "countries/Katanga.txt"
SIN = "countries/Singapore.txt"
#Somali Anarchy
SML = "countries/Somaliland.txt"
USF = "countries/United Somali Forces.txt"
STF = "countries/Somali National Front.txt"
SPO = "countries/Somali Patriotic Movement.txt"
USR = "countries/United Somali Front.txt"
SDE = "countries/Somali Democratic Alliance.txt"
USO = "countries/United Somali Party.txt"
SMI = "countries/Somali Africans Muke Organization.txt"
UDS = "countries/United Somali Congress.txt" 
MVO = "countries/Somali Salvation Democratic Front"
MDE = "countries/Somali Democratic Alliance" 
VFF = "countries/Vereinigte Freikorpsfront.txt"
